Cut	 برش
Binomial distribution	 توزیع دو جمله ای
portable	 حمل‌پذیر
media	 رسانه
thread	 رشته
Router	 رهیاب
Copy	 رونوشت
hierarchy	 سلسله‌مراتب
Metadata	 فرا داده
independence	 نابستگی
Navigation	 ناوش
editor	 ویراستار
Bitmap	 نگاشت بیت
bracket	 کروشه
compact	(داده) چکیده
Palm	(رایانه) جیبی
Notebook	(رایانه) كتابی
Laptop	(رایانه) كیفی
Display	(صفحه‌ی) نمایش
InkJet	(چاپگر) جوهرافشان
Home	(كلید) آغازه
Control	(كلید) مهار
pause	(كلید) مكث
Up-Arrow	(كلید) بالابر
SHIFT	(كلید) تبدیل
INSERT	(كلید) درج
Tab	(كلید) جهش
ALT	(كلید) دگرساز
SPACE	(كلید) فاصله
Enter	(كلید) ورود
Backspace	(كلید) پس‌بر
escape	(كلید) گریز
NumLock	(كلید) قفل اعداد
CapsLock	(كلید) قفل تبدیل
Function	(كلید)کار
window titlebar	م&#1740;له عنوان پنجره
ready	آماده
statistical	آماری
rendezvous	ملاقات
privileged	ممتاز
slash	ممیز
fixed-point	ممیزِ ثابت
floating-point	ممیزِ شناور
backslash	ممیزِ وارونه
training	آموزش
financial	مالی
Owner	مالک
matrix	ماتریس
mime	مایم
Padding	لایی گذاری
Layer	لایه
machine	ماشین
Turing machine	ماشینِ تیورینگ
typewriter	ماشین‌تحریر
Calculator	ماشین‌حساب
satellite	ماهواره
Lambda	لاندا
remainder	مانده
bin	لاوک
triangle	مثلث
trigonometric	مثلثاتی
Swap	مبادله کردن
converter	مبدل
Number Converter	مبدل عدد
compiler	مترجم
translator	مترجم
cascade	آبشاری
canonical	متعارف
Variable	متغیر
environment variable	متغیر محیطی
edge	لبه
ambiguous	مبهم
Source	متن
Text	متن
context	متن
Open Source	متن باز
plain text	متن ساده
shaped text	متن شکیل
consecutive	متوالی
serial	متوالی
successive	متوالی
Hex	مبنای شانزده
proportional	متناسب
symmetric	متقارن
Location	محل
Model	مدل
Solid model	مدل توپر
data model	مدل داده‌ایی
Local	محلی
locale	محلی
locality	محلی
bar	میله
Scroll Bar	میله لغزش
Tool bar	میله ابزار
Task bar	میله تکلیف
launch bar	میله راه انداز
Status Bar	میله وضعیت
Progress Bar	میله پیشرفت
Menubar	میله گزینگان
sum	مجموع
checksum	مجموعِ مقابله‌ای
fork	محلِ انشعاب
raster	محلِ تصویر
locate	محل‌یابی
Circuit	مدار
Legal	مجاز
computing	محاسبات
calculation	محاسبه
computation	محاسبه
compute	محاسبه کردن
Virtual	مجازی
shield	محافظ
Screen Saver	محافظ صفحه نمایش
Web-Shortcut	میان بر وب
dialog	محاوره
Median	میانه
temporary buffer	میانگیر موقت
mean	میانگین
shortcut	میان‌بر
Buffer	میان‌گیر
integrated	مجتمع
integration	مجتمع‌سازی
Content	محتوا
entry	مدخل
Manager	مدیر
schedule manager	مدیر زمانبندی
management	مدیریت
power management	مدیریت توان
Window Manager	مدیریت پنجره
memory management	مدیریتِ حافظه
environment	محیط
Desktop Environment	محیط رومیزی
Homogeneous environment	محیط همگن
Confidential	محرمانه
Privacy	محرمانگی
Channel	مجرا
alpha channel	مجرای آلفا
Secure channel	مجرای امن
transmission channel	مجرای انتقال
Abstract	مجرد
Adjust	میزان کردن
tune	میزان کردن
bit rate	میزانِ ارسالِ بیت
tuning	میزان‌سازی
Host	میزبان
local host	میزبان محلی
Unknown host	میزبان ناشناخته
pool	مخزن
sensible	محسوس
Hide	مخفی كردن
fading	محو کردن
minix	مینیکس
axis	محور
circular	مدور
shaft	محور
y-axis	محور عمودی
x-axis	محور طول‌ها
Permission	مجوز
GPL	مجوز عمومی
mirror	آینه ای
Linux	لینوکس
IDE	آی‌دی‌ای
Benchmark	محك
Lookup	مراجعه
Array	آرایه
Descending sort	مرتب سازی نزولی
Sort	مرتب کردن
sorter	مرتب‌کننده
square	مربع
stage	مرحله
reference	مرجع
jitter	لرزش
visible	مرئی
review	مرور
browse	مرور
Browser	مرورگر
Center	مرکز
compound	مرکّب
ink	مرکّب
testing	آزمایش
tester	آزماینده
Test	آزمون
Betatest	آزمون ب
trade-off	مصالحه
free	آزاد
viewer	مشاهده‌گر
Threshold	آستانه
common	مشترک
Share	مشترک
Rectangle	مستطیل
straight	مستقیم
damage	آسیب
vulnerable	آسیب‌پذیر
Path	مسیر
route	مسیر
real path	مسیر حقیقی
full pathname	مسیر کامل
routing	مسیریابی
Highlight	مشخص
specific	مشخص
specify	مشخص کردن
specification	مشخصه
Problem	مسئله
Detection	آشکارسازی
architecture	معماری
pending	معلق
Suspend	معلق
Equation	معادله
Start	آغاز
initial	آغازین
Home Page	آغازه
Dismiss	معاف کردن
valid	معتبر
criterion	معیار
criteria	معیارها
ledger	معین
Slider	لغزان
scrolling	لغزاندن
Scroll	لغزیدن
Cancel	لغو
semantic	معنایی
magnetic	مغناطیسی
significant	معنی‌دار
Hangup	معوق
reverse	معکوس
reasonable	معقول
pivot	مفصل
interpreter	مفسر
attacker	مهاجم
dialect	لهجه
time stamp	مهر زمان
generator	مولد
composer	مؤلف
component	مؤلفه
Pipe	لوله
Conduit	لوله
Regression analysis	آنالیز برگشتی
parallel	موازی
resource	منبع
supply	منبع
wave	موج
Modem	مودم
Curve	منحنی
stock	موجودی
oblique	مورب
Mouse	موشی
Obsolete	منسوخ
regular	منظم
Regulate	منظم کردن
Landscape	منظره
negative	منفی
passive	منفعل
Subject	موضوع
punch	منگنه
logic	منطق
Logical	منطقی
Region	منطقه
zone	منطقه
temporary	موقت
position	موقعیت
suppress	موقوف کردن
mega	مگا
megabyte	مگابایت
complement	مکمل
supplement	مکمل
Mouse Cursor	مکان نمای موشی
brace	آکولاد
reliable	مطمئن
absolute	مطلق
emulator	مقلد
Collate	مقابله کردن
compare	مقایسه کردن
resistance	مقاومت
nickname	لقب
Resident	مقیم
Value	مقدار
Modal (value)	مقدار وجهی
initialization	مقداردهیِ اولیه
Scale	مقیاس
scaling	مقیاس بندی
Scalable	مقیاس پذیر
type bindings	مقید سازی نوع
Binding	مقیدسازی
Destination	مقصد
milestone	مقطعِ مهم
Blinking cursor	مكان نمای چشمك‌زن
cursor	مكانْ‌نما
Concatenate	الحاق
alphabet	الفبا
alphanumeric	الفبا-عددی
secure	امن
Security	امنیت
signature	امضاء
Pattern	الگو
algorithm	الگوریتم
feasible	امکان‌پذیر
inductor	القاگر
proof	اثبات
fingerprint	اثر انگشت
Supercomputer	ابررایانه
Ethernet	اترنت
Connection	اتصال
Tool	ابزار
tool menu	ابزار گزینگان
safe	ایمن
Continue	ادامه
continuation	ادامه
Authorization	اجازه
permit	اجازه دادن
probability	احتمال
union	اجتماع
optional	اختیاری
dedicate	اختصاص دادن
dedicated	اختصاصی
dedication	اختصاص‌دهی
Undelete	احیا
Create	ایجاد
execution	اجرا
Run	اجرا
Authentication	احراز هویت
stop	ایست
static	ایستا
station	ایستگاه
workstation	ایستگاه كار
assertion	ادعا
Merge	ادغام
Internet	اینترنت
invoke	احضار کردن
Notice	اخطار
Notification	اخطار
Warning	اخطار
presentation	ارائه
Submit	ارائه دادن
communication	ارتباط
vibration	ارتعاش
Upgrade	ارتقا
Cross-reference	ارجاعِ متقابل
skew	اریب
Send	ارسال
Outbox	ارسالی
evaluation	ارزیابی
Resume	از سر گرفتن
Redo	از نو
Origin	اصل
Password	اسم رمز
modification	اصلاح
correction	اصلاح
fallback	اصلاحِ حالتِ عمل
master	اصلی
nominal	اسمی
instruction pointer	اشاره گر دستور
pointer	اشاره‌گر
Saturation	اشباع
Standard	استاندارد
exploit	استثمار
Exception	استثناء
extraction	استخراج
Extract	استخراج
Intersect	اشتراک
sharing	اشتراک
subscription	اشتراک
timesharing	اشتراکِ زمانی
use	استفاده
networking	استفاده از شبکه
reuse	استفاده‌ی مجدد
cylinder	استوانک
Busy	اشغال
spool	اسپول
mail spool	اسپول نامه
bug	اشکال
Internal bug	اشکال درونی
Debug	اشکال زدایی
software bug	اشکال نرم افزاری
debugger	اشکال‌زدا
debugging	اشکال‌زدایی
SCSI	اسکازی
Ascii	اسکی
Term	اصطلاح
prompt	اعلان
validity	اعتبار
validate	اعتبارسنجی
validation	اعتبارسنجی
distortion	اعوجاج
Drop	افت
Intercept	افتراق
Partition	افراز
partitioning	افراز
Increase	افزودن
joystick	اهرمِ کنترل
Priority	اولویت
stacker	انباره‌ساز
stacking	انباره‌سازی
Cumulative	انباشتی
accumulated	انباشته
assignment	انتساب
Propagation	انتشار
Wait	انتظار
bulk	انبوه
aggregation	انبوهش
Aggregate	انبوهه
integral	انتگرال
Transfer	انتقال
transmission	انتقال
linear transfer	انتقال خطی
peak	اوج
association	انجمن
cardinality	اندازه
size	اندازه
page size	اندازه‌ی صفحه
gage	اندازه‌گیر
measurement	اندازه‌گیری
sizing	اندازه‌گیری
offset	انحراف
Standard deviation	انحرافِ معیار
Interaction	اندرکنش
denied	انكار
XML	اکس‌ام‌ال
Information	اطلاعات
Save	ذخیره کردن
store	ذخیره کردن
stored	ذخیره‌شده
Storage	ذخیره‌گاه
trapezoid	ذوزنقه
Timeout	تمام وقت
full duplex	تمام‌دوسویه
delay	تأخیر
lag	تأخیر
ticket	بلیط
collating	تلفیق
trap	تله
trapping	تله‌گذاری
crystal	بلور
block	بلوک
block buffer	بلوک میان‌گیر
signature block	بلوک امضاء
bad block	بلوک خراب
reserved blocks	بلوکهای ذخیره
top	بالا
pop-up	بالا پراندن
upper	بالایی
Uppercase	بالایی
Superscript	بالانویس
Tolerance	تاب
Panel	تابلو
Bulletin Board	تابلوی اعلانات
constant	ثابت
battery	باتری
functional	تابعی
Byte	بایت
fan	بادبزن
Confirmation	تایید
Confirm	تایید کردن
archive	بایگانی
tar archive	بایگانی بان
Download	بار گیری
load	بار کردن
Opacity	تاری
History	تاریخچه
firewall	بارو
overload	بارِ اضافی
reload	بارگذاری مجدد
upload	بارگذاشتن
loader	بارکننده
Open	باز
blocking	باز داشت
Readout	باز خوانی
Reset	باز نشانی
rearrange	بازآرایی
Restart	بازآغازی
Refreshing	بازآوری
Refresh	بازآوردن
retrieval	بازیابی
Retrieve	بازیابی
recovery	بازیافت
feedback	بازخورد
inspector	بازرس
recognition	بازشناخت
representation	بازنمایی
rewrite	بازنویسی
Relay	بازپخش
rewind	بازپیچی
restore	بازگرداندن
Recursion	بازگشت
Return	بازگشت
recursive	بازگشتی
unpack	بازکردن
Tar	بان (بایگانی نوار)
band	باند
second	ثانیه
secondary	ثانویه
register	ثبات
Logging	ثبت
Log	ثبت كردن
Conversion	تبدیل
transform	تبدیل
wireless	بی سیم
Analysis	تحلیل
Flow analysis	تحلیل روند
analyzer	تحلیل‌کننده
dump	تخلیه
dumping	تخلیه
Meeting	تجمع
commercial	تجاری
preparation	تدارکِ آمایش
Bit	بیت
Check bit	بیت بررسی
Board	تخته (مدار)
Clipboard	تخته یادداشت
wake up	بیدار شدن
trivial	بدیهی
critical	بحرانی
Destroy	تخریب
destruction	تخریب
typing	تحریر
sharp	تیز
portion	بخش
section	بخش
Visualization	تجسم
get	بدست آوردن
allocation	تخصیص
decomposition	تجزیه
parsing	تجزیه
Parse	تجزیه کردن
parser	تجزیه‌گر
maximal	بیشین
maximum	بیشینه
maximize	بیشینه ساختن
equipment	تجهیزات
International	بین المللی
primitive	بدوی
body	بدنه
Main body	بدنه اصلی
Untitled	بدون عنوان
Tick	تیک
unused	بی‌استفاده
Real time	بی‌درنگ
TCP/IP	تی‌سی‌پی/آی‌پی
unsigned	بی‌علامت
Anonymous	بی‌نام
unbiased	بی‌پیش‌قدر
Idle	بی‌کار
unbounded	بی‌کران
Load-on-Demand	بر اساس نیاز بار کردن
sibling	برادر
X Align	تراز افقی
Vertical Alignment	تراز عمودی
y-align	تراز عمودی
alignment	تراز کردن
justification	ترازبندی
transistor	ترانزیستور
Transpose	ترانهادن
Transitive	تراگذری
transaction	تراکنش
Order	ترتیب
ordinal	ترتیبی
Ascending order	ترتیبِ صعودی
compilation	ترجمه
translation	ترجمه
Translate	ترجمه کردن
vector	بردار
removable	برداشتنی
Collision	برخورد
On-Line	برخط
check	بررسی
clip	برش
slice	برش
Trim	برش
truncation	برش
drawing	ترسیم
bare	برهنه
go	برو
Program	برنامه
Startup Program	برنامه راه اندازی
Object code	برنامه‌ی مقصود
programmed	برنامه‌ریزی‌شده
programmer	برنامه‌ساز
programming	برنامه‌سازی
Applet	برنامک
Incremental update	بروز رسانی نموی
Output	برونداد
Off-line	برون‌خط
Setup	برپایی
Label	برچسب
tag	برچسب
leaf	برگ
Recurrence	برگشت
Form	برگه
combination	ترکیب
Frequency	بسامد
Random	تصادفی
connector	بست
test-bed	بسترِ آزمون
Package	بسته
Packet	بسته
RPM package	بسته آرپی‌ام
Close	بستن
x-large	بسیار بزرگ
x-small	بسیار کوچک
commit	تصدیق
speed-up	تسریع
mainframe	بزرگ (رایانه)
Zoom	بزرگ نمایی
facility	تسهیلات
image	تصویر
Blur image	تصویر محو
Pixel	تصویر دانه
visual	تصویری
snapshot	تصویرِ لحظه‌ای
expansion	بسط
generalization	تعمیم
suspension	تعلیق
interactive	تعاملی
Dimension	بعد
successor	بعدی
alteration	تغییر
Modify	تغییر
variation	تغییر
vary	تغییر
Resize	تغییر اندازه
redirect	تغییر جهت دادن
Modifier	تغییر دهنده
Rename	تغییر نام
shifting	تغییرِمکان‌دهی
definition	تعریف
user-defined	تعریف‌شده توسطِ کاربر
undefined	تعریف‌نشده
shutdown	تعطیل
subtract	تفریق
tail	ته
Update	به روز رسانی
optimal	بهینه
optimization	بهینه‌سازی
gain	بهره
updating	به‌روزکردن
mod	به‌پیمانه
Indent	تو رفتگی
indentation	تو رفتگی
Boolean	بولی
succession	توالی
Balance	توازن
correspondence	تناظر
License agreement	توافق نامه مجوز
booster	توان افزا
Software Foundation	بنیاد نرم افزار
chunk	توده(ای)
heap	توده(ای)
Grid	توری
Normal distribution	توزیع نرمال
Poisson distribution	توزیع پو آسون
Distribute	توزیع کردن
Descriptor	توصیفگر
qualifier	توصیف‌کننده
adjustment	تنظیم
preference	تنظیم
comment	توضیح
Bold	توپر
Built-in	توکار
Halt	توقف
pulse	تپش
beat	تپش
single	تک
supplementary	تکمیل
task	تکلیف
singular	تکین
iteration	تکرار
Repeat	تکرار
repeater	تکرارکننده
fragment	تکه
monochrome	تک‌رنگ
matching	تطابق
match	تطبیق
emulation	تقلید
precedence	تقدم
approximation	تقریب
division	تقسیم
Division by zero	تقسیم برصفر
Calendar	تقویم
solution	حل
attack	حمله
sentence	جمله
portability	حمل‌پذیری
temperature	دما
summary	خلاصه
reason	دلیل
add	جمع کردن
subtotal	جمعِ جزئی
collect	جمع‌آوری
front	جلو
Loop	حلقه
ring	حلقه
OR	یا
Place	جا
spot	خال
carrier	حامل
system settings	حالات سیستم
case	حالت
Mode	حالت
use case	حالت استفاده
Answer mode	حالت پاسخ
Unload	خالی کردن
off	خاموش
Domain	دامنه
scope	دامنه
Search Domains	دامنه جستجو
MTU	یاب(یکای ارسال بیشینه)
displacement	جابه‌جایی
interleaved	جای داده
sticky notes	یاداشت چسبناک
mnemonic	یادیار
Data	داده
Raw data	داده‌های خام
wizard	جادوگر
database	دادگان
Replace	جایگزینی
placement	جای‌دهی
Overwrite	جای‌نوشت
overlay	جای‌گذاشت
permutation	جای‌گشت
replacement	جای‌گزینی
pin	خار
Current	جاری
quotient	خارجِ‌قسمت
margin	حاشیه
capacitor	خازن
jam	داغان کردن
Find	یافتن
Memory	حافظه
Shared Memory	حافظه مشترک
Resident memory	حافظه مقیم
Raw memory	حافظه خام
Real Memory	حافظه حقیقی
physical memory	حافظه فیزیکی
expanded memory	حافظه‌ی بسط‌یافته
backing store	حافظه‌ی پشتیبان
Accessory	جانبی
substitute	جانشین کردن
substitution	جانشینی
Housekeeping	خانه‌داری
family	خانواده
absorption	جذب
Delete	حذف
deletion	حذف
erase	حذف
Remove	حذف
anti-aliasing	حذفِ لبه‌ی ناصاف
bubble	حباب
zombie	یتیم
limit	حد
Volume	حجم(صدا)
Service	خدمت
DNS	خدمت نام دامنه
xx-large	خیلی بزرگ
xx-small	خیلی کوچک
Separator	جدا ساز
delimiter	جداساز
Severity	جدی
severe	جدی
Viewport	دیدگاه
disc	دیسک
disk	دیسک
cdrom	دیسک فشرده
diskette	دیسکت
Hard Disk	دیسکِ سخت
CD	دیسك فشرده
jiffy	جیفی
Table	جدول
tabulator	جدول‌بند
tabulation	جدول‌بندی
tabulate	جدول‌بندی کردن
corrupt	خراب
fail	خراب شدن
failure	خرابی
failsafe	خرابی ایمن
thermal	حرارتی
junk	خرت و پرت
insertion	درج
mini icons	خرد شمایل
Receive	دریافت
inbox	دریافتی
stream	جریان
Tree	درخت
Tree View	درخت نما
Rating	درجه بندی
quadratic	درجه دوم
calibration	درجه‌بندی
request	درخواست
Gate	دریچه
true	درست
Letter	حرف
hash	درهم
gateway	دروازه
Exit	خروج
Logout	خروج
Quit	خروج
boldface	حروفِ سیاه
internal	درونی
Input	درونداد
inline	درون‌برنامه‌ای
interpolation	درون‌یابی
port	درگاه
Move	حرکت
Sense	حس
part	جزء
Account	حساب
accounting	حساب‌داری
Sensitive	حساس
Case Sensitive	حساس به حالت
sensitivity	حساسیت
Handshake	دست دادن
Perl Script	دست نوشته پرل
access	دستیابی
DMA	دستیابی مستقیم به حافظه
Availability	دسترس‌پذیری
batch	دسته
deck	دسته
Transfer statement	دستور انتقالی
instruction	دستورالعمل
grammar	دستورِ زبان
Device	دستگاه
mixer device	دستگاه مخلوط کن
Pilot device	دستگاه راهبری
Dialout Device	دستگاه شماره‌گیر
inaccessible	دست‌یابی‌ناپذیر
accessibility	دست‌یابی‌پذیری
Search	جست‌وجو
Script	دست‌نوشته
manipulation	دست‌کاری
Attribute	خصیصه
partial	جزئی
private	خصوصی
sensor	حسگر
Text Box	جعبه متن
Dialog Box	جعبه محاوره
Size box	جعبه اندازه
check box	جعبه بررسی
Combo Box	جعبه ترکیب
Spinbox	جعبه دوار
List Box	جعبه فهرست
Drop Down Box	جعبه پایین افت
Check Boxes	جعبه‌های بررسی
protect	حفاظت
Protection	حفاظت
write-protection	حفاظت از نوشتن
couple	جفت
Post Office	دفتر پست
World wide web	جهان وب
Direction	جهت
Orientation	جهت
decimal	ده‌دهی
Negative Binomial	دو جمله‌ای منفی
duration	دوام
Sleep	خواب
readable	خوانا
readability	خوانایی
read	خواندن
read-write	خواندن/نوشتن
reader	خواننده
sequence	دنباله
double click	دوبار فشار دادن
Reboot	دوباره راه اندازی کردن
peripheral	جنبی
stand-alone	خوداتکا
gear	دنده
Autofill	خودکار پر کردن
automation	خودکارسازی
Remote	دور
Discard	دور انداختن
Fax	دور نگار
feed	خوراندن
period	دوره
Periodic	دوره‌ای
hybrid	دورگه
tic-tac-toe	دوزبازی
cluster	خوشه
Field	حوزه
bidirectional	دوسویه
duplex	دوسویه
well-formed	خوش‌ترکیب
toner	جوهر
Unicode	یونی کد
UNIX	یونیکس
colon	دونقطه (:)
dual	دوگان
Binary	دوگانی
cooling	خنک‌سازی
twin	دوقلو
bipolar	دوقطبی
Button	دگمه
Radio Button	دگمه رادیویی
statement	حکم
pushbutton	دکمه فشاری
unique	یکتا
Unidirectional	یک‌جهته
rectifier	یک‌سوساز
uniform	یک‌نواخت
Line	خط
Policy	خط مشی، سیاست
Underscore	خط تیره زیرین
Crop	خط برش
Solid lines	خط تو پر
Underline	خط زیر
Command Line	خط فرمان
baseline	خط کرسی
Error	خطا
Critical error	خطای بحرانی
Internal error	خطای درونی
unexpected error	خطای غیرمنتظره
Syntax error	خطای نحوی
Type mismatch	خطای نوع
diagnosis	خطایابی
linear	خطی
pipeline	خطِ لوله
dash	خطِ تیره
hyphen	خطِ تیره
Copyright	حق نشر
accuracy	دقت
Resolution	دقت
precision	دقت
real	حقیقی
cipher	رمز
vertex	رأس
encryption	رمزبندی
encrypt	رمزبندی كردن
cryptography	رمزنگاری
opcode	رمزِ عمل
relation	رابطه
Relationship	رابطه
relational	رابطه‌ای
E-mail	رایانامه
Computer	رایانه
Radio	رادیو
right	راست
way	راه
launch	راه انداختن
Launcher	راه انداز
Application Launcher	راه انداز کاربرد
boot	راه اندازی
Startup	راه اندازی
strategy	راهبرد
guide	راهنما
Manual	راهنما
robot	ربات
Rank	رتبه
mathematical	ریاضی
trace	ردیابی
tracing	ردیابی
occurrence	رخداد
X-Position	ردیف ایکس
Y-Position	ردیف وای
micro	ریز
Thumb Nails	ریز نقش
Firmware	ریزبرنامه
Root	ریشه
Revert	رجعت(بازگشتن به حالت اولیه)
Class	رده
Classification	رده بندی
hack	رخنه كردن
Hacker	رخنه‌گر
Reject	ردکردن
tracking	رد‌گیری
plot	رسم کردن
formal	رسمی
plotter	رسام
medium	رسانه
String	رشته
search string	رشته جست‌وجو
directive	رهنمود
Desktop	رومیزی
Virtual Desktop	رومیزی مجازی
routine	روال
Event	رویداد
procedure	رویّه
method	روش
up-to-date	روزآمد
access method	روشِ دست‌یابی
flow	روند
Flowchart	روندنما
Hue	رنگ
Secondary Colors	رنگ ثانویه
Primary Colors	رنگهای اصلی
digit	رقم
numeral	رقم
digital	رقمی
carry	رقمِ نَقلی
Hello World	سلام به دنیا
Icon	شمایل
launch icon	شمایل راه اندازی
enumeration	شمارش
count	شمارش
enumerated	شمارشی
counter	شمارشگر
dial up	شماره گیری
dial	شماره‌گیری
redial	شماره‌گیری مجدد
time	زمان
run-time	زمان اجرا
timing	زمان بندی
Uptime	زمان دایر بودن
down time	زمانِ بی‌کاری
idle time	زمانِ بی‌کاری
compile-time	زمانِ ترجمه
scheduler	زمان‌بند
Schedule	زمان‌بندی
Timer	زمان‌سنج
side	سمت
rightmost	سمتِ‌راست‌ترین
Background	زمینه
hierarchical	سلسله‌مراتبی
hierachy	سلسه مراتب
Cell	سلول
char cell	سلول نویسه‌ای
Cellular	سلولی
inclusive	شامل
Histogram	سابقه‌نما
seashore	ساحل دریا
structure	ساختار
stub	ساخته‌گی
Build	ساختن
dummy	ساختگی
structured	ساخت‌یافته
Export	صادر(ات)
Indicator	شاخص
Peak indicator	شاخص اوج
branch	شاخه
simple	ساده
contrast	سایه‌روشن
simplex	سادک
organization	سازمان
constructor	سازنده
mechanism	سازوکار
consistent	سازگار
consistency	سازگاری
clock	ساعت
hexadecimal	شانزده‌شانزدهی
abort	ساقط کردن
Trash	زباله
Accelerator	شتاب‌ده
acceleration	شتاب‌دهی
star	ستاره
asterisk	ستاره (*)
Language	زبان
FORTRAN	زبانِ فورترن
Daemon	شبح
Unix-like	شبیه یونیكس
simulation	شبیه‌سازی
column	ستون
Style	سبک
token ring	شبکه‌ی حلقوی
Network	شبكه
LAN	شبكه داخلی
WAN	شبكه گسترده
wire	سیم (کشی)
traffic	شدآمد
silicon	سیلیسیوم
voice	صدا
track	شیار
Hardware	سخت‌افزار
substring	زیر رشته
Subnet	زیر شبکه
I/O subsystem	زیر سیستم ورود و خروج
Submenu	زیر فهرست
Footer	زیر نویس
subset	زیرمجموعه
subprogram	زیربرنامه
subtree	زیردرخت
subroutine	زیرروال
Infrastructure	زیرساخت
subsystem	زیرسیستم
Subdirectory	زیرفهرست
Subscript	زیرنویس
System	سیستم
Filesystem	سیستم پرونده
Operating System	سیستمِ عامل
head	سر
topic	سر فصل
decrypt	سر گشایی
Headword	سر کلمه
Header	سرآیند
Global	سراسری
overflow	سرریز
velocity	سرعت
speed	سرعت
acronym	سرنام
administrator	سرپرست
System Administrator	سرپرست سیستم
Administration	سرپرستی
System-Administration	سرپرستی سیستم
Condition	شرط
Urgent condition	شرط مبرم
conditional	شرطی
radius	شعاع
Retry	سعی مجدد
Queue	صف
Customize	سفارشی کردن
Transparent	شفاف
Page	صفحه
sheet	صفحه
canvas	صفحه مجازی
Man page	صفحه راهنما
Manual page	صفحه راهنما
Web Page	صفحه وب
Secure keyboard	صفحه کلید امن
paging	صفحه‌بندی
spreadsheet	صفحه‌ی گسترده
Keyboard	صفحه‌كلید
zero	صفر
Intuitive	شهودی
triple	سه‌گانه
object	شئ
Mount	سوار کردن
identification	شناسایی
ID	شناسه
Identifier	شناسه
PID	شناسه فرآیند
Process ID	شناسه فرآیند
userid	شناسه كاربر
Float	شناور
sound	صوت
Audio	صوتی
Document	سند
utility	سودمند
chain	زنجیر
switch	سوده
Keep Alive	زنده نگاهداری
switching	سودهی
Postal Box	صندوق پستی
perforated	سوراخ‌دار
HTML	زنگام(زبان نشانه گذاری ابرمتن)
Socket	سوکت
pseudo	شِبه
decryption	سِر گشایی
shape	شکل
figure	شکل
gap	شکاف
slot	شکاف
split	شکافتن
break	شکستن
crack	شکستن
platform	سکو
level	سطح
surface	سطح
low-level	سطحِ پایین
Row	سطر
Wrap	سطر بندی
Operation	عمل
operational	عملیاتی
operand	عملوند
operator	عملگر
sign	علامت
Public	عمومی
Universal	عمومی
Portrait	عمودی
vertical	عمودی
spell-check	غلط یاب
Spell Checker	غلط‌گیر
depth	عمق
factor	عامل
Scaling Factor	عامل مقیاس بندی
User Agent	عامل كاربر
predominantly	غالبا
normal	عادی
appearance	ظاهر
expression	عبارت
phrase	عبارت
Regular expression	عبارت منظم
pass-phrase	عبارت عبور
fault	عیب
minor faults	عیب کوچک
Segmentation Fault	عیب قطعه بندی
numerical	عددی
Numeric	عددی
integer	عددِ صحیح
Illegal	غیر مجاز
non-numeric	غیرعددی
unclassified	غیرِسرّی
Width	عرض
Uninstall	عزل
element	عنصر
Widget	عنصر
Resource element	عنصر منبع
Caption	عنوان
Title	عنوان
picture	عکس
conjunction	عطف
rollback	عقب گرد
Floppy	فلاپی
Blank	فاصله
Interval	فاصله
Gutter	فاصله ستون ها
whitespace	فاصله سفید
spacing	فاصله‌گذاری
factorial	فاکتوریل
fuse	فیوز
Command	فرمان
Process	فرآیند
Formula	فرمول
Metafile	فرا پرونده
development	فرابری
Call	فراخوانی
callback	فراخوانی برگشتی
odd	فرد
transmit	فرستادن
sender	فرستنده
transmitter	فرستنده
child	فرزند
Vendor	فروشنده
crash	فروپاشی
assumption	فرض
click	فشار دادن
push	فشار دادن
Zip	فشرده
compression	فشرده سازی
Pack	فشردن
Active	فعال
activity	فعالیت
activation	فعال‌سازی
Enable	فعال‌سازی
catalog	فهرست
list	فهرست
TODO List	فهرست انجام
user directory	فهرست راهنمای کاربر
Root Directory	فهرست ریشه
Icon List	فهرست شمایل
Numbered List	فهرست شمارشی
Home directory	فهرست شخصی
listing	فهرست نویسی
Wish list	فهرست کام
working directory	فهرست کاری
Directory	فهرستِ راهنما
technique	فن
technology	فناوری
technical	فنی
True Type	فونت حقیقی
superclass	فوقِ رده
hypertext	فوق‌متن
workspace	فضای کار
item	فقره
Text only	فقط متن
Write-only	فقط نوشتنی
read-only	فقط‌خواندنی
Justify	هم تراز کردن
Align	هم ترازکردن
harmonic	هماهنگ
similar	همانند
Correlation	همبستگی
Pearson Correlation	همبستگی پیرسون
fusion	همجوشی
concurrent	همروند
compatible	همساز
upward compatible	همسازِ بالایی
smooth	هموار
smoothing	هموارسازی
Coprocessor	همپرداز
overlap	همپوشانی
synchronous	همگام
Synchronize	همگام ساختن
synchronization	همگامی
synchronized	همگام‌شده
homogeneous	همگن
Collaboration	همکاری
equivalence	هم‌ارزی
Hollerith	هالریت
Spell	هجی
target	هدف
prune	هرس کردن
Spam	هرزنامه
Spam assassin	هرزنامه کش
maze	هزارتوی
octal	هشت هشتی
entity	هستار
core	هسته
Kernel	هسته
hard core	هسته‌ی اصلی
Alarm	هشدار
normalization	هنجارسازی
identity	هویت
Geometry	هندسه
intelligent	هوشمند
Smart	هوشمند
AND	و
exponent	نما
View	نما
Symbol	نماد
Scientific notation	نماد گذاری
visibility	نمایانی
exponential	نمایی
symbolic	نمادی
Show	نمایش
Redisplay	نمایش مجدد
Reverse video	نمایش معکوس
Monitor	نمایشگر، پایشگر
Index	نمایه
indexing	نمایه‌گذاری
voltage	ولتاژ
increment	نمو
Diagram	نمودار
structure diagram	نمودار ساختاری
Sample	نمونه
Sampling	نمونه‌برداری
prototype	نمونه‌ی اولیه
nOT	نا
name	نام
textual name	نام متنی
Host name	نام میزبان
domain name	نام دامنه
Filename	نام پرونده
Username	نام كاربر
unbalanced	نامتوازن
infinite	نامتناهی
Invisible	نامرئی
Invalid	نامعتبر
Mail	نامه
Mail to	نامه (دادن) به
Electronic Mail	نامه الکترونیکی
Mailbox	نامه‌دان
renaming	نام‌دهیِ دوباره
naming	نام‌گذاری
alias	نام‌گردان
unreliable	نامطمئن
pure	ناب
unequal	نابرابر
Dependence	وابستگی
Disable	ناتوان‌سازی
nOR	نایا
unity	واحد
unit	واحد
CPU	واحد پردازش مركزی
area	ناحیه
text area	ناحیه متن
Timezone	ناحیه زمان
Print area	ناحیه چاپ
false	نادرست
wrong	نادرست
fuzzy	نادقیق
fuzziness	نادقیقی
Import	وارد(ات)
Pooled Variance	واریانس اشتراکی
Variance	واریانس( در آمار)
checkout	وارسی
verification	وارسی
Verify	وارسی کردن
Invert	وارونه
inverter	وارونگر
inconsistency	ناسازگاری
unknown	ناشناخته
Interface	واسط
Graphical user interface	واسط نگاره‌ای کاربر
User Interface	واسط کاربر
Hub	ناف
incompatibility	ناهمسازی
Asynchronous	ناهمگام
Navigate	ناویدن
NAND	ناوَ
navigator	ناوشگر
unstable	ناپایدار
WordProcessing	واژه‌پردازی
lexical	واژه‌گانی
Undo	واگرد
Bounce	واگشت
fetch	واکشی
actual	واقعی
Web	وب
web-based	وب بنیاد
webmaster	وب دار
Netscape	نت سکیپ
Blog	وب نوشت
result	نتیجه
subsequent	نتیجه
printout	نتیجه‌ی چاپی
website	وب‌گاه
Standby	نیمه روشن
semi-automatic	نیمه‌خودکار
ancestor	نیا
requirement	نیاز
video	ویدئو
editing	ویرایش
Edit	ویرایش
destructor	ویرانگر
modal	وجهی
syntax	نحو
Ticker Properties	ویژگیهای تیکی
Properties	ویژگی‌ها
Common properties	ویژگی‌های مشترک
feature	ویژ‌گی
threading	نخ‌کشی
Free Software	نرم افزار آزاد
SOFTWARE	نرم‌افزار
inheritance	وراثت
Scalar	نرده(ای)
Login	ورود
Input/output	ورودی/خروجی
generation	نسل
Plug-in	وصل شدنی
Mark	نشان
Exponential notation	نشان گذاری نمایی
Address	نشانی
IP Address	نشانی اینترنتی
URL	نشانی وب
addressing	نشانی‌دهی
token	نشانه
Argument	نشانوند
line arguments	نشانوندهای خط
marker	نشانگر
Signal	نشانک
semaphore	نشان‌بر
notation	نشان‌گذاری
Install	نصب
installation	نصب
Ratio	نسبت
relative	نسبی
Version	نسخه
insensitive version	نسخه غیر حساس
Release	نشر
Session	نشست
weight	وزن
theoretical	نظری
theory	نظریه
Number Theory	نظریه اعداد
intrusion	نفوذ
Cache	نهان گاه
embedded	نهفته
Tone	نوا
cassette	نوار
ribbon	نوار
tape	نوار
character	نویسه
Space character	نویسه فاصله
literal	نویسه‌ی لفظی
wildcard	نویسه‌ی عام
Special character	نویسه‌ی ویژه
Character set	نویسه‌گان
carriage	نورد
optical	نوری
write	نوشتن
Type	نوع
mime-type	نوع مایم
media type	نوع رسانه
object type	نوع شئ
typical	نوعی
data type	نوعِ داده
noise	نوفه
noisy	نوفه آلود
GUI	ونک (واسط نگاره ای کاربر)
situation	وضعیت
State	وضعیت
Status	وضعیت
Vector Graphics	نگاره سازی  برداری
graphic	نگاره‌ای
mapping	نگاشت
Pixmap	نگاشت تصویر دانه ای
Radar map	نگاشت رادار
retention	نگهداری
maintenance	نگهداشت
hold	نگهداشتن
Quote	نقل قول
mask	نقاب
Netmask	نقاب شبکه
masking	نقاب‌گذاری
plan	نقشه
Interrupt	وقفه
violation	نقض
Segmentation violation	نقض قطعه بندی
Point	نقطه
Insertion point	نقطه درج
semicolon	نقطه-واوک
branch point	نقطه‌ی انشعاب
breakpoint	نقطه‌ی انفصال
punctuation	نقطه‌گذاری
implicit	ضمنی
toggle	ضامن
Record	ضبط
impulse	ضربه
strike	ضربه زدن
Coefficient	ضریب
aspect ratio	ضریبِ نسبت
refinement	پالایش
Filter	پالایه
Palette	پالت
stable	پایا
stability	پایابی
Terminate	پایان دادن
termination	پایان دهی
Unexpected end	پایان غیر منتظره
Terminal	پایانه
Smart terminal	پایانه‌ی هوشمند
dumb Terminal	پایانه‌ی ناهوشمند
terminating	پایان‌بخش
terminator	پایان‌بخش
Stabilize	پایدار ساختن
bottom	پایین
lower-case	پایینی
Monitoring	پایشگری
base	پایه
basic	پایه‌ای
site	پایگاه
News Site	پایگاه اخبار
Parameter	پارامتر
answer	پاسخ
response	پاسخ
Clear	پاک کردن
purge	پاک‌سازی
Accept	پذیرفتن
Pager	پی جو
Module	پیمانه
Test Module	پیمانه آ زمایش
modular	پیمانه‌ای
traverse	پیمودن
Message	پیام
Private Messages	پیام خصوصی
Implementation	پیاده‌سازی
parent	پدر
Forecast	پیش بینی
forward	پیش سو
Preview	پیش نمایش
console	پیشانه
Progress	پیشرفت
Prefix	پیشوند
Proxy	پیشکار
proxy server	پیشکار
proxy service	پیشکاری
precompiler	پیش‌مترجم
Foreground	پیش‌زمینه
precondition	پیش‌شرط
pre-edit	پیش‌ویرایش
proposal	پیش‌نهاد
Draft	پیش‌نویس
preprocessor	پیش‌پرداز
preprocessing	پیش‌پردازی
prevention	پیش‌گیری
Default	پیش‌گزیده
Attachment	پیوست
continuous	پیوسته
Append	پیوستن
join	پیوند
Link	پیوند
linker	پیوند ده
Symbolic Link	پیوند نمادی
junction	پیوندگاه
ping	پینگ
complexity	پیچید‌گی
coil	پیچه
System Configuration	پیکر بندی سیستم
Configuration	پیکربندی
slave	پی‌رو
seek	پی‌گردی
Fill	پر کردن
paranthesis	پرانتز
scatter	پراکنده کردن
ray	پرتو
render	پرداخت
Processing	پردازش
child process	پردازه فرزند
Processor	پردازنده
VERBOSE	پرحرف
Screen	پرده
Snap	پرش
Skip	پرش
Query	پرس‌وجو
inquiry	پرس‌وجو
Prodigy	پرودیگی
File	پرونده
log file	پرونده ثبت
target file	پرونده هدف
Core file	پرونده هسته
Watch file	پرونده پایش
Hidden file	پرونده پنهان
startup files	پرونده‌های راه اندازی
project	پروژه
flag	پرچم
Residual	پس مانده
Eject	پس زدن
postscript	پست اسکریپت
Encapsulated Postscript	پست اسکریپت کپسوله شده
Backup	پشتیبان
backing	پشتیبانی
Support	پشتیبانی
subshell support	پشتیبانی زیر پوسته
Stack	پشته
tandem	پشتِ سرِ هم
trailer	پشت‌بند
Favorites	پسندان
Extension	پسوند
postfix	پسوند
Suffix	پسوند
backward	پس‌ سو
Post Processor	پس‌پرداز
broadband	پهن-باند
bandwidth	پهنای باند
Dynamic	پویا
animation	پویا نمایی
Scan	پوییدن
Window	پنجره
window-based	پنجره مبنا
Tabbed Window	پنجره جدول بندی شده
Root Window	پنجره ریشه
custom window	پنجره سفارشی
Inactive window	پنجره غیر فعال
scanning	پویش
Scanner	پویشگر
quintuple	پنج‌گانه
Shell	پوسته
Folder	پوشه
cover	پوشن
void	پوچ
nil	پوچ
null	پوچ
Echo	پژواک
sink	چاه
Print	چاپ
Printer	چاپگر
Snooze	چرت
wheel	چرخ
Rotate	چرخش
rotary	چرخشی
cycle	چرخه
cyclic	چرخه‌ای
ignore	چشم پوشی
Blinking	چشمك‌زنی
Paste	چسباندن
quad	چهارگانه
Theme	چهره
bookmark	چوب- الف
Polygon	چند ضلعی
Polyline	چند ضلعی
multichannel	چندمجرایی
multi-purpose	چندمنظوره
multimedia	چندرسانه‌ای
multikey	چندکلیدی
multi-user	چندکاربره
grab	چنگ انداختن
digest	چکیده
Bullet	گلوله
phase	گام
step	گام
Gamma	گاما
transition	گذار
pass	گذر
transit	گذر
throughput	گذر دهی
transient	گذرا
Bus	گذرگاه
USB	گذرگاه سریال جهانی
Capture	گیر اندازی
receiver	گیرنده
Receptivity	گیرندگی
giga	گیگا
heat	گرما
Gradient	گرادیان
Graph	گراف
Handle	گرداندن
handling	گرداندن
drive	گرداننده
driver	گرداننده
handler	گرداننده
Jaz Drive	گرداننده جاز
node	گره
Inode	گره اطلاعاتی
Group	گروه
report	گزارش
profiler	گزارش‌گیر
torque	گشتاورِ نیروی پیچشی
spread	گسترده
Range	گستره
span	گستره
Criteria range	گستره معیارها
Select	گزیدن
Selection	گزینش
Invert Selection	گزینش وارونه
selector	گزیننده
Color Selector	گزیننده رنگ
Menu	گزینگان
popup menu	گزینگان بالاپر
Discrete	گسسته
trackball	گوی کنترلی
rational	گویا
GNU	گنو
round	گِرد
round-off	گِرد کردن
round up	گِرد کردنِ افزایشی
round-down	گِرد کردنِ کاهشی
Chat	گپ
total	کل
Arc	کمان
Macro	کلان‌دستور
Key	کلید
Hot Key	کلید میانبر
Private key	کلید خصوصی
Arrow key	کلید جهت
Public Key	کلید عمومی
Win-key	کلید ویندوز
soft keys	کلیدهای نرم افزاری
Keyword	کلیدواژه
Stereotype	کلیشه
minimal	کمین
minimum	کمینه
Minimize	کمینه ساختن
quantity	کمیّت
Help	کمک
auxiliary	کمکی
full	کامل
cable	کابل
Job	کار
work	کار
work group	کار گروه
performance	کارایی
Actuator	کارانداز
card	کارت
sound card	کارت صوتی
Application	کاربرد
usage	کاربرد
cartridge	کارتریج
applied	کاربردی
worksheet	کاربرگ
client	کارخواه
Mail Client	کارخواه نامه
Server	کارساز
SOCKS Server	کارساز SOCKS
Mail server	کارساز نامه
Decrease	کاستن
reduction	کاهش
reduce	کاهش دادن
Druid	کاهن
explore	کاوش
focus	کانون
address book	کتاب نشانی
Workbook	کتاب کار
protected workbooks	کتاب کار حفاظت شده
Library	کتابخانه
handbook	کتابِ مرجع
code	کد
bar code	کد میله‌ای
Source code	کد منبع
ZIP code	کد منطقه‌ی پستی
Encoding	کد بندی
error code	کد خطا
coding	کد گذاری
decode	کد گشایی کردن
Kilobyte	کیلو بایت
encoder	کدبند
encode	کدبندی کردن
Skewness	کجی
Slant	کجی
quality	کیفیت
decoder	کدگشا
decoding	کدگشایی
codec	کدک
worm	کرم
bound	کران
boundary	کرانه
kerberos	کربروس
Kill	کشتن
Kill app	کشتن کاربرد
drag	کشیدن
Fraction	کسر
strain	کشش
quantum	کوانتوم
controller	کنترل‌کننده
action	کنش
Actor	کنشگر
cookie	کوکی
pile	کپه
patch	کژنه
drum	طبله
natural	طبیعی
design	طرح
Layout	طرح بندی
Outline	طرحِ کلی
schema	طرح‌واره
Length	طول
pen	قلم
Font	قلم
Proportional font	قلم متناسب
Fixed Font	قلم ثابت
HTTP	قام(قرارداد انتقال ابرمتن)
Format	قالب
Template	قالب
Time format	قالب زمان
Interchange File Format	قالب پرونده تبادل پذیر
formatted	قالب‌بندی شده
formating	قالب‌دار
usable	قابل استفاده
Frame	قابک
Child frame	قابک فرزند
rule	قاعده
rulebased	قاعده‌مند
FTP	قاپ(قرارداد انتقال پرونده)
predecessor	قبلی
analogy	قیاس
Analog	قیاسی
Constraint	قید
Protocol	قرارداد
pop	قرارداد دفترپست
Lock	قفل
cabinet	قفسه
polar	قطبی
Diagonal	قطری
Segment	قطعه
code segment	قطعه کد
segmentation	قطعه‌بندی
Disconnect	قطعِ ارتباط
Shift key	كلید تبدیل
User	كاربر
user-friendly	كاربرپسند
Wallpaper	كاغذ دیواری
